
⬛⬛⬛⬛⬛⬛⬛⬛⬛⬛⬛⬛⬛⬛⬛⬛⬛⬛⬛
⬛🟩🟩⬜⬜⬜⬜⬜⬜⬜⬜⬜⬜⬜⬜⬜⬜⬜⬛
⬛🟩🟩⬜⬜⬜⬜⬜⬜⬜⬜⬜⬜⬜⬜⬜⬜⬜⬛
⬛⬜⬜⬛⬛⬛⬛⬜⬜⬛⬜⬜⬛⬛⬛⬛⬛⬛⬛
⬛⬜⬜⬜⬜⬜⬛⬜⬜⬛⬜⬜⬜⬜⬜⬜⬜⬜⬛
⬛⬜⬜⬜⬜⬜⬛⬜⬜⬛⬜⬜⬜⬜⬜⬜⬜⬜⬛
⬛⬜⬜⬛⬜⬜⬛⬛⬛⬛⬜⬜⬛⬛⬛⬛⬜⬜⬛
⬛⬜⬜⬛⬜⬜⬜⬜⬜⬛⬜⬜⬜⬜⬜⬛⬜⬜⬛
⬛⬜⬜⬛⬜⬜⬜⬜⬜⬛⬜⬜⬜⬜⬜⬛⬜⬜⬛
⬛⬜⬜⬛⬛⬛⬛⬜⬜⬛⬛⬛⬛⬜⬜⬛⬜⬜⬛
⬛⬜⬜⬜⬜⬜⬛⬜⬜⬜⬜⬜⬛⬜⬜⬛⬜⬜⬛
⬛⬜⬜⬜⬜⬜⬛⬜⬜⬜⬜⬜⬛⬜⬜⬛⬜⬜⬛
⬛⬜⬜⬛⬜⬜⬛⬜⬜⬛⬜⬜⬛⬜⬜⬛⬜⬜⬛
⬛⬜⬜⬛⬜⬜⬛⬜⬜⬛⬜⬜⬛⬜⬜⬛⬜⬜⬛
⬛⬜⬜⬛⬜⬜⬛⬜⬜⬛⬜⬜⬛⬜⬜⬛⬜⬜⬛
⬛⬜⬜⬛⬜⬜⬛⬛⬛⬛⬜⬜⬛⬜⬜⬛⬛⬛⬛
⬛⬜⬜⬛⬜⬜⬜⬜⬜⬛⬜⬜⬛⬜⬜⬜🟥🟥⬛
⬛⬜⬜⬛⬜⬜⬜⬜⬜⬛⬜⬜⬛⬜⬜⬜🟥🟥⬛
⬛⬛⬛⬛⬛⬛⬛⬛⬛⬛⬛⬛⬛⬛⬛⬛⬛⬛⬛

