
⬛⬛⬛⬛⬛⬛⬛⬛⬛⬛⬛⬛⬛⬛⬛⬛⬛⬛⬛⬛⬛⬛
⬛🟩🟩⬜⬜⬜⬜⬜⬜⬜⬜⬜⬜⬜⬜⬜⬜⬜⬜⬜⬜⬛
⬛🟩🟩⬜⬜⬜⬜⬜⬜⬜⬜⬜⬜⬜⬜⬜⬜⬜⬜⬜⬜⬛
⬛⬜⬜⬛⬛⬛⬛⬛⬛⬛⬛⬛⬛⬜⬜⬛⬛⬛⬛⬜⬜⬛
⬛⬜⬜⬜⬜⬜⬜⬜⬜⬜⬜⬜⬛⬜⬜⬜⬜⬜⬛⬜⬜⬛
⬛⬜⬜⬜⬜⬜⬜⬜⬜⬜⬜⬜⬛⬜⬜⬜⬜⬜⬛⬜⬜⬛
⬛⬜⬜⬛⬛⬛⬛⬛⬛⬛⬛⬛⬛⬛⬛⬛⬜⬜⬛⬛⬛⬛
⬛⬜⬜⬜⬜⬜⬜⬜⬜⬜⬜⬜⬜⬜⬜⬛⬜⬜⬜⬜⬜⬛
⬛⬜⬜⬜⬜⬜⬜⬜⬜⬜⬜⬜⬜⬜⬜⬛⬜⬜⬜⬜⬜⬛
⬛⬜⬜⬛⬜⬜⬛⬛⬛⬛⬛⬛⬛⬜⬜⬛⬛⬛⬛⬜⬜⬛
⬛⬜⬜⬛⬜⬜⬜⬜⬜⬜⬜⬜⬛⬜⬜⬜⬜⬜⬛⬜⬜⬛
⬛⬜⬜⬛⬜⬜⬜⬜⬜⬜⬜⬜⬛⬜⬜⬜⬜⬜⬛⬜⬜⬛
⬛⬜⬜⬛⬜⬜⬛⬛⬛⬛⬛⬛⬛⬛⬛⬛⬜⬜⬛⬜⬜⬛
⬛⬜⬜⬛⬜⬜⬜⬜⬜⬜⬜⬜⬜⬜⬜⬛⬜⬜⬛⬜⬜⬛
⬛⬜⬜⬛⬜⬜⬜⬜⬜⬜⬜⬜⬜⬜⬜⬛⬜⬜⬛⬜⬜⬛
⬛⬜⬜⬛⬜⬜⬛⬜⬜⬛⬜⬜⬛⬛⬛⬛⬛⬛⬛⬛⬛⬛
⬛⬜⬜⬛⬜⬜⬛⬜⬜⬛⬜⬜⬜⬜⬜⬜⬜⬜⬜⬜⬜⬛
⬛⬜⬜⬛⬜⬜⬛⬜⬜⬛⬜⬜⬜⬜⬜⬜⬜⬜⬜⬜⬜⬛
⬛⬜⬜⬛⬛⬛⬛⬜⬜⬛⬛⬛⬛⬜⬜⬛⬜⬜⬛⬜⬜⬛
⬛⬜⬜⬜⬜⬜⬛⬜⬜⬜⬜⬜⬛⬜⬜⬛⬜⬜⬛🟥🟥⬛
⬛⬜⬜⬜⬜⬜⬛⬜⬜⬜⬜⬜⬛⬜⬜⬛⬜⬜⬛🟥🟥⬛
⬛⬛⬛⬛⬛⬛⬛⬛⬛⬛⬛⬛⬛⬛⬛⬛⬛⬛⬛⬛⬛⬛

