
⬛⬛⬛⬛⬛⬛⬛⬛⬛⬛⬛⬛⬛⬛⬛⬛⬛⬛⬛⬛⬛⬛
⬛🟩🟩⬜⬜⬜⬜⬜⬜⬜⬜⬜⬜⬜⬜⬜⬜⬜⬜⬜⬜⬛
⬛🟩🟩⬜⬜⬜⬜⬜⬜⬜⬜⬜⬜⬜⬜⬜⬜⬜⬜⬜⬜⬛
⬛⬜⬜⬛⬛⬛⬛⬜⬜⬛⬜⬜⬛⬜⬜⬛⬛⬛⬛⬛⬛⬛
⬛⬜⬜⬜⬜⬜⬛⬜⬜⬛⬜⬜⬛⬜⬜⬜⬜⬜⬜⬜⬜⬛
⬛⬜⬜⬜⬜⬜⬛⬜⬜⬛⬜⬜⬛⬜⬜⬜⬜⬜⬜⬜⬜⬛
⬛⬜⬜⬛⬜⬜⬛⬛⬛⬛⬜⬜⬛⬛⬛⬛⬜⬜⬛⬜⬜⬛
⬛⬜⬜⬛⬜⬜⬜⬜⬜⬛⬜⬜⬜⬜⬜⬛⬜⬜⬛⬜⬜⬛
⬛⬜⬜⬛⬜⬜⬜⬜⬜⬛⬜⬜⬜⬜⬜⬛⬜⬜⬛⬜⬜⬛
⬛⬜⬜⬛⬜⬜⬛⬜⬜⬛⬛⬛⬛⬜⬜⬛⬜⬜⬛⬛⬛⬛
⬛⬜⬜⬛⬜⬜⬛⬜⬜⬜⬜⬜⬛⬜⬜⬛⬜⬜⬜⬜⬜⬛
⬛⬜⬜⬛⬜⬜⬛⬜⬜⬜⬜⬜⬛⬜⬜⬛⬜⬜⬜⬜⬜⬛
⬛⬜⬜⬛⬜⬜⬛⬜⬜⬛⬜⬜⬛⬜⬜⬛⬛⬛⬛⬜⬜⬛
⬛⬜⬜⬛⬜⬜⬛⬜⬜⬛⬜⬜⬛⬜⬜⬜⬜⬜⬛⬜⬜⬛
⬛⬜⬜⬛⬜⬜⬛⬜⬜⬛⬜⬜⬛⬜⬜⬜⬜⬜⬛⬜⬜⬛
⬛⬜⬜⬛⬛⬛⬛⬛⬛⬛⬜⬜⬛⬛⬛⬛⬛⬛⬛⬛⬛⬛
⬛⬜⬜⬜⬜⬜⬜⬜⬜⬛⬜⬜⬜⬜⬜⬜⬜⬜⬜⬜⬜⬛
⬛⬜⬜⬜⬜⬜⬜⬜⬜⬛⬜⬜⬜⬜⬜⬜⬜⬜⬜⬜⬜⬛
⬛⬜⬜⬛⬜⬜⬛⬛⬛⬛⬛⬛⬛⬜⬜⬛⬛⬛⬛⬜⬜⬛
⬛⬜⬜⬛⬜⬜⬜⬜⬜⬜⬜⬜⬛⬜⬜⬜⬜⬜⬛🟥🟥⬛
⬛⬜⬜⬛⬜⬜⬜⬜⬜⬜⬜⬜⬛⬜⬜⬜⬜⬜⬛🟥🟥⬛
⬛⬛⬛⬛⬛⬛⬛⬛⬛⬛⬛⬛⬛⬛⬛⬛⬛⬛⬛⬛⬛⬛


⬛⬛⬛⬛⬛⬛⬛⬛⬛⬛⬛⬛⬛⬛⬛⬛⬛⬛⬛⬛⬛⬛
⬛🟩🟩⬜⬜⬜⬜⬜⬜⬜⬜⬜⬜⬜⬜⬜⬜⬜⬜⬜⬜⬛
⬛🟩🟩⬜⬜⬜⬜⬜⬜⬜⬜⬜⬜⬜⬜⬜⬜⬜⬜⬜⬜⬛
⬛⬜⬜⬛⬜⬜⬛⬜⬜⬛⬜⬜⬛⬜⬜⬛⬜⬜⬛⬛⬛⬛
⬛⬜⬜⬛⬜⬜⬛⬜⬜⬛⬜⬜⬛⬜⬜⬛⬜⬜⬜⬜⬜⬛
⬛⬜⬜⬛⬜⬜⬛⬜⬜⬛⬜⬜⬛⬜⬜⬛⬜⬜⬜⬜⬜⬛
⬛⬜⬜⬛⬛⬛⬛⬛⬛⬛⬛⬛⬛⬜⬜⬛⬛⬛⬛⬛⬛⬛
⬛⬜⬜⬜⬜⬜⬜⬜⬜⬜⬜⬜⬛⬜⬜⬜⬜⬜⬜⬜⬜⬛
⬛⬜⬜⬜⬜⬜⬜⬜⬜⬜⬜⬜⬛⬜⬜⬜⬜⬜⬜⬜⬜⬛
⬛⬜⬜⬛⬜⬜⬛⬛⬛⬛⬛⬛⬛⬜⬜⬛⬛⬛⬛⬜⬜⬛
⬛⬜⬜⬛⬜⬜⬜⬜⬜⬜⬜⬜⬛⬜⬜⬜⬜⬜⬛⬜⬜⬛
⬛⬜⬜⬛⬜⬜⬜⬜⬜⬜⬜⬜⬛⬜⬜⬜⬜⬜⬛⬜⬜⬛
⬛⬜⬜⬛⬜⬜⬛⬜⬜⬛⬛⬛⬛⬜⬜⬛⬛⬛⬛⬜⬜⬛
⬛⬜⬜⬛⬜⬜⬛⬜⬜⬜⬜⬜⬛⬜⬜⬜⬜⬜⬛⬜⬜⬛
⬛⬜⬜⬛⬜⬜⬛⬜⬜⬜⬜⬜⬛⬜⬜⬜⬜⬜⬛⬜⬜⬛
⬛⬜⬜⬛⬛⬛⬛⬛⬛⬛⬜⬜⬛⬛⬛⬛⬜⬜⬛⬜⬜⬛
⬛⬜⬜⬜⬜⬜⬜⬜⬜⬛⬜⬜⬜⬜⬜⬛⬜⬜⬛⬜⬜⬛
⬛⬜⬜⬜⬜⬜⬜⬜⬜⬛⬜⬜⬜⬜⬜⬛⬜⬜⬛⬜⬜⬛
⬛⬜⬜⬛⬛⬛⬛⬛⬛⬛⬛⬛⬛⬛⬛⬛⬛⬛⬛⬛⬛⬛
⬛⬜⬜⬜⬜⬜⬜⬜⬜⬜⬜⬜⬜⬜⬜⬜⬜⬜⬜🟥🟥⬛
⬛⬜⬜⬜⬜⬜⬜⬜⬜⬜⬜⬜⬜⬜⬜⬜⬜⬜⬜🟥🟥⬛
⬛⬛⬛⬛⬛⬛⬛⬛⬛⬛⬛⬛⬛⬛⬛⬛⬛⬛⬛⬛⬛⬛


⬛⬛⬛⬛⬛⬛⬛⬛⬛⬛⬛⬛⬛⬛⬛⬛⬛⬛⬛⬛⬛⬛
⬛🟩🟩⬜⬜⬜⬜⬜⬜⬜⬜⬜⬜⬜⬜⬜⬜⬜⬜⬜⬜⬛
⬛🟩🟩⬜⬜⬜⬜⬜⬜⬜⬜⬜⬜⬜⬜⬜⬜⬜⬜⬜⬜⬛
⬛⬜⬜⬛⬜⬜⬛⬜⬜⬛⬛⬛⬛⬛⬛⬛⬛⬛⬛⬛⬛⬛
⬛⬜⬜⬛⬜⬜⬛⬜⬜⬜⬜⬜⬜⬜⬜⬜⬜⬜⬜⬜⬜⬛
⬛⬜⬜⬛⬜⬜⬛⬜⬜⬜⬜⬜⬜⬜⬜⬜⬜⬜⬜⬜⬜⬛
⬛⬜⬜⬛⬛⬛⬛⬛⬛⬛⬛⬛⬛⬛⬛⬛⬛⬛⬛⬛⬛⬛
⬛⬜⬜⬜⬜⬜⬜⬜⬜⬜⬜⬜⬜⬜⬜⬜⬜⬜⬜⬜⬜⬛
⬛⬜⬜⬜⬜⬜⬜⬜⬜⬜⬜⬜⬜⬜⬜⬜⬜⬜⬜⬜⬜⬛
⬛⬜⬜⬛⬜⬜⬛⬛⬛⬛⬜⬜⬛⬛⬛⬛⬛⬛⬛⬛⬛⬛
⬛⬜⬜⬛⬜⬜⬜⬜⬜⬛⬜⬜⬜⬜⬜⬜⬜⬜⬜⬜⬜⬛
⬛⬜⬜⬛⬜⬜⬜⬜⬜⬛⬜⬜⬜⬜⬜⬜⬜⬜⬜⬜⬜⬛
⬛⬜⬜⬛⬜⬜⬛⬜⬜⬛⬛⬛⬛⬛⬛⬛⬜⬜⬛⬛⬛⬛
⬛⬜⬜⬛⬜⬜⬛⬜⬜⬜⬜⬜⬜⬜⬜⬛⬜⬜⬜⬜⬜⬛
⬛⬜⬜⬛⬜⬜⬛⬜⬜⬜⬜⬜⬜⬜⬜⬛⬜⬜⬜⬜⬜⬛
⬛⬜⬜⬛⬜⬜⬛⬛⬛⬛⬛⬛⬛⬜⬜⬛⬜⬜⬛⬛⬛⬛
⬛⬜⬜⬛⬜⬜⬜⬜⬜⬜⬜⬜⬛⬜⬜⬛⬜⬜⬜⬜⬜⬛
⬛⬜⬜⬛⬜⬜⬜⬜⬜⬜⬜⬜⬛⬜⬜⬛⬜⬜⬜⬜⬜⬛
⬛⬜⬜⬛⬛⬛⬛⬜⬜⬛⬛⬛⬛⬜⬜⬛⬜⬜⬛⬜⬜⬛
⬛⬜⬜⬜⬜⬜⬛⬜⬜⬜⬜⬜⬛⬜⬜⬛⬜⬜⬛🟥🟥⬛
⬛⬜⬜⬜⬜⬜⬛⬜⬜⬜⬜⬜⬛⬜⬜⬛⬜⬜⬛🟥🟥⬛
⬛⬛⬛⬛⬛⬛⬛⬛⬛⬛⬛⬛⬛⬛⬛⬛⬛⬛⬛⬛⬛⬛


⬛⬛⬛⬛⬛⬛⬛⬛⬛⬛⬛⬛⬛⬛⬛⬛⬛⬛⬛⬛⬛⬛
⬛🟩🟩⬜⬜⬜⬜⬜⬜⬜⬜⬜⬜⬜⬜⬜⬜⬜⬜⬜⬜⬛
⬛🟩🟩⬜⬜⬜⬜⬜⬜⬜⬜⬜⬜⬜⬜⬜⬜⬜⬜⬜⬜⬛
⬛⬜⬜⬛⬛⬛⬛⬜⬜⬛⬛⬛⬛⬜⬜⬛⬜⬜⬛⬜⬜⬛
⬛⬜⬜⬜⬜⬜⬛⬜⬜⬜⬜⬜⬛⬜⬜⬛⬜⬜⬛⬜⬜⬛
⬛⬜⬜⬜⬜⬜⬛⬜⬜⬜⬜⬜⬛⬜⬜⬛⬜⬜⬛⬜⬜⬛
⬛⬜⬜⬛⬛⬛⬛⬛⬛⬛⬛⬛⬛⬛⬛⬛⬜⬜⬛⬜⬜⬛
⬛⬜⬜⬜⬜⬜⬜⬜⬜⬜⬜⬜⬜⬜⬜⬛⬜⬜⬛⬜⬜⬛
⬛⬜⬜⬜⬜⬜⬜⬜⬜⬜⬜⬜⬜⬜⬜⬛⬜⬜⬛⬜⬜⬛
⬛⬜⬜⬛⬛⬛⬛⬜⬜⬛⬜⬜⬛⬛⬛⬛⬜⬜⬛⬜⬜⬛
⬛⬜⬜⬜⬜⬜⬛⬜⬜⬛⬜⬜⬜⬜⬜⬛⬜⬜⬛⬜⬜⬛
⬛⬜⬜⬜⬜⬜⬛⬜⬜⬛⬜⬜⬜⬜⬜⬛⬜⬜⬛⬜⬜⬛
⬛⬜⬜⬛⬛⬛⬛⬛⬛⬛⬛⬛⬛⬛⬛⬛⬛⬛⬛⬛⬛⬛
⬛⬜⬜⬜⬜⬜⬜⬜⬜⬜⬜⬜⬜⬜⬜⬜⬜⬜⬜⬜⬜⬛
⬛⬜⬜⬜⬜⬜⬜⬜⬜⬜⬜⬜⬜⬜⬜⬜⬜⬜⬜⬜⬜⬛
⬛⬜⬜⬛⬛⬛⬛⬛⬛⬛⬜⬜⬛⬜⬜⬛⬛⬛⬛⬛⬛⬛
⬛⬜⬜⬜⬜⬜⬜⬜⬜⬛⬜⬜⬛⬜⬜⬜⬜⬜⬜⬜⬜⬛
⬛⬜⬜⬜⬜⬜⬜⬜⬜⬛⬜⬜⬛⬜⬜⬜⬜⬜⬜⬜⬜⬛
⬛⬜⬜⬛⬜⬜⬛⬜⬜⬛⬜⬜⬛⬜⬜⬛⬛⬛⬛⬛⬛⬛
⬛⬜⬜⬛⬜⬜⬛⬜⬜⬛⬜⬜⬛⬜⬜⬜⬜⬜⬜🟥🟥⬛
⬛⬜⬜⬛⬜⬜⬛⬜⬜⬛⬜⬜⬛⬜⬜⬜⬜⬜⬜🟥🟥⬛
⬛⬛⬛⬛⬛⬛⬛⬛⬛⬛⬛⬛⬛⬛⬛⬛⬛⬛⬛⬛⬛⬛


⬛⬛⬛⬛⬛⬛⬛⬛⬛⬛⬛⬛⬛⬛⬛⬛⬛⬛⬛⬛⬛⬛
⬛🟩🟩⬜⬜⬜⬜⬜⬜⬜⬜⬜⬜⬜⬜⬜⬜⬜⬜⬜⬜⬛
⬛🟩🟩⬜⬜⬜⬜⬜⬜⬜⬜⬜⬜⬜⬜⬜⬜⬜⬜⬜⬜⬛
⬛⬜⬜⬛⬜⬜⬛⬜⬜⬛⬛⬛⬛⬛⬛⬛⬜⬜⬛⬛⬛⬛
⬛⬜⬜⬛⬜⬜⬛⬜⬜⬜⬜⬜⬜⬜⬜⬛⬜⬜⬜⬜⬜⬛
⬛⬜⬜⬛⬜⬜⬛⬜⬜⬜⬜⬜⬜⬜⬜⬛⬜⬜⬜⬜⬜⬛
⬛⬜⬜⬛⬛⬛⬛⬜⬜⬛⬜⬜⬛⬜⬜⬛⬜⬜⬛⬜⬜⬛
⬛⬜⬜⬜⬜⬜⬛⬜⬜⬛⬜⬜⬛⬜⬜⬛⬜⬜⬛⬜⬜⬛
⬛⬜⬜⬜⬜⬜⬛⬜⬜⬛⬜⬜⬛⬜⬜⬛⬜⬜⬛⬜⬜⬛
⬛⬜⬜⬛⬛⬛⬛⬛⬛⬛⬜⬜⬛⬜⬜⬛⬜⬜⬛⬛⬛⬛
⬛⬜⬜⬜⬜⬜⬜⬜⬜⬛⬜⬜⬛⬜⬜⬛⬜⬜⬜⬜⬜⬛
⬛⬜⬜⬜⬜⬜⬜⬜⬜⬛⬜⬜⬛⬜⬜⬛⬜⬜⬜⬜⬜⬛
⬛⬜⬜⬛⬜⬜⬛⬛⬛⬛⬛⬛⬛⬜⬜⬛⬛⬛⬛⬜⬜⬛
⬛⬜⬜⬛⬜⬜⬜⬜⬜⬜⬜⬜⬛⬜⬜⬜⬜⬜⬛⬜⬜⬛
⬛⬜⬜⬛⬜⬜⬜⬜⬜⬜⬜⬜⬛⬜⬜⬜⬜⬜⬛⬜⬜⬛
⬛⬜⬜⬛⬜⬜⬛⬜⬜⬛⬜⬜⬛⬛⬛⬛⬛⬛⬛⬜⬜⬛
⬛⬜⬜⬛⬜⬜⬛⬜⬜⬛⬜⬜⬜⬜⬜⬜⬜⬜⬛⬜⬜⬛
⬛⬜⬜⬛⬜⬜⬛⬜⬜⬛⬜⬜⬜⬜⬜⬜⬜⬜⬛⬜⬜⬛
⬛⬜⬜⬛⬛⬛⬛⬛⬛⬛⬛⬛⬛⬜⬜⬛⬜⬜⬛⬜⬜⬛
⬛⬜⬜⬜⬜⬜⬜⬜⬜⬜⬜⬜⬛⬜⬜⬛⬜⬜⬛🟥🟥⬛
⬛⬜⬜⬜⬜⬜⬜⬜⬜⬜⬜⬜⬛⬜⬜⬛⬜⬜⬛🟥🟥⬛
⬛⬛⬛⬛⬛⬛⬛⬛⬛⬛⬛⬛⬛⬛⬛⬛⬛⬛⬛⬛⬛⬛


⬛⬛⬛⬛⬛⬛⬛⬛⬛⬛⬛⬛⬛⬛⬛⬛⬛⬛⬛⬛⬛⬛
⬛🟩🟩⬜⬜⬜⬜⬜⬜⬜⬜⬜⬜⬜⬜⬜⬜⬜⬜⬜⬜⬛
⬛🟩🟩⬜⬜⬜⬜⬜⬜⬜⬜⬜⬜⬜⬜⬜⬜⬜⬜⬜⬜⬛
⬛⬜⬜⬛⬛⬛⬛⬛⬛⬛⬜⬜⬛⬜⬜⬛⬜⬜⬛⬜⬜⬛
⬛⬜⬜⬜⬜⬜⬜⬜⬜⬛⬜⬜⬛⬜⬜⬛⬜⬜⬛⬜⬜⬛
⬛⬜⬜⬜⬜⬜⬜⬜⬜⬛⬜⬜⬛⬜⬜⬛⬜⬜⬛⬜⬜⬛
⬛⬜⬜⬛⬜⬜⬛⬜⬜⬛⬛⬛⬛⬛⬛⬛⬜⬜⬛⬛⬛⬛
⬛⬜⬜⬛⬜⬜⬛⬜⬜⬜⬜⬜⬜⬜⬜⬛⬜⬜⬜⬜⬜⬛
⬛⬜⬜⬛⬜⬜⬛⬜⬜⬜⬜⬜⬜⬜⬜⬛⬜⬜⬜⬜⬜⬛
⬛⬜⬜⬛⬜⬜⬛⬜⬜⬛⬜⬜⬛⬛⬛⬛⬛⬛⬛⬛⬛⬛
⬛⬜⬜⬛⬜⬜⬛⬜⬜⬛⬜⬜⬜⬜⬜⬜⬜⬜⬜⬜⬜⬛
⬛⬜⬜⬛⬜⬜⬛⬜⬜⬛⬜⬜⬜⬜⬜⬜⬜⬜⬜⬜⬜⬛
⬛⬜⬜⬛⬛⬛⬛⬛⬛⬛⬜⬜⬛⬛⬛⬛⬛⬛⬛⬛⬛⬛
⬛⬜⬜⬜⬜⬜⬜⬜⬜⬛⬜⬜⬜⬜⬜⬜⬜⬜⬜⬜⬜⬛
⬛⬜⬜⬜⬜⬜⬜⬜⬜⬛⬜⬜⬜⬜⬜⬜⬜⬜⬜⬜⬜⬛
⬛⬜⬜⬛⬜⬜⬛⬜⬜⬛⬛⬛⬛⬜⬜⬛⬛⬛⬛⬜⬜⬛
⬛⬜⬜⬛⬜⬜⬛⬜⬜⬜⬜⬜⬛⬜⬜⬜⬜⬜⬛⬜⬜⬛
⬛⬜⬜⬛⬜⬜⬛⬜⬜⬜⬜⬜⬛⬜⬜⬜⬜⬜⬛⬜⬜⬛
⬛⬜⬜⬛⬛⬛⬛⬛⬛⬛⬜⬜⬛⬜⬜⬛⬜⬜⬛⬛⬛⬛
⬛⬜⬜⬜⬜⬜⬜⬜⬜⬛⬜⬜⬛⬜⬜⬛⬜⬜⬜🟥🟥⬛
⬛⬜⬜⬜⬜⬜⬜⬜⬜⬛⬜⬜⬛⬜⬜⬛⬜⬜⬜🟥🟥⬛
⬛⬛⬛⬛⬛⬛⬛⬛⬛⬛⬛⬛⬛⬛⬛⬛⬛⬛⬛⬛⬛⬛


⬛⬛⬛⬛⬛⬛⬛⬛⬛⬛⬛⬛⬛⬛⬛⬛⬛⬛⬛⬛⬛⬛
⬛🟩🟩⬜⬜⬜⬜⬜⬜⬜⬜⬜⬜⬜⬜⬜⬜⬜⬜⬜⬜⬛
⬛🟩🟩⬜⬜⬜⬜⬜⬜⬜⬜⬜⬜⬜⬜⬜⬜⬜⬜⬜⬜⬛
⬛⬜⬜⬛⬜⬜⬛⬜⬜⬛⬛⬛⬛⬛⬛⬛⬛⬛⬛⬛⬛⬛
⬛⬜⬜⬛⬜⬜⬛⬜⬜⬜⬜⬜⬜⬜⬜⬜⬜⬜⬜⬜⬜⬛
⬛⬜⬜⬛⬜⬜⬛⬜⬜⬜⬜⬜⬜⬜⬜⬜⬜⬜⬜⬜⬜⬛
⬛⬜⬜⬛⬛⬛⬛⬜⬜⬛⬜⬜⬛⬜⬜⬛⬜⬜⬛⬜⬜⬛
⬛⬜⬜⬜⬜⬜⬛⬜⬜⬛⬜⬜⬛⬜⬜⬛⬜⬜⬛⬜⬜⬛
⬛⬜⬜⬜⬜⬜⬛⬜⬜⬛⬜⬜⬛⬜⬜⬛⬜⬜⬛⬜⬜⬛
⬛⬜⬜⬛⬜⬜⬛⬛⬛⬛⬛⬛⬛⬛⬛⬛⬛⬛⬛⬜⬜⬛
⬛⬜⬜⬛⬜⬜⬜⬜⬜⬜⬜⬜⬜⬜⬜⬜⬜⬜⬛⬜⬜⬛
⬛⬜⬜⬛⬜⬜⬜⬜⬜⬜⬜⬜⬜⬜⬜⬜⬜⬜⬛⬜⬜⬛
⬛⬜⬜⬛⬛⬛⬛⬛⬛⬛⬛⬛⬛⬛⬛⬛⬛⬛⬛⬜⬜⬛
⬛⬜⬜⬜⬜⬜⬜⬜⬜⬜⬜⬜⬜⬜⬜⬜⬜⬜⬛⬜⬜⬛
⬛⬜⬜⬜⬜⬜⬜⬜⬜⬜⬜⬜⬜⬜⬜⬜⬜⬜⬛⬜⬜⬛
⬛⬜⬜⬛⬜⬜⬛⬛⬛⬛⬜⬜⬛⬜⬜⬛⬛⬛⬛⬛⬛⬛
⬛⬜⬜⬛⬜⬜⬜⬜⬜⬛⬜⬜⬛⬜⬜⬜⬜⬜⬜⬜⬜⬛
⬛⬜⬜⬛⬜⬜⬜⬜⬜⬛⬜⬜⬛⬜⬜⬜⬜⬜⬜⬜⬜⬛
⬛⬜⬜⬛⬛⬛⬛⬜⬜⬛⬜⬜⬛⬛⬛⬛⬛⬛⬛⬛⬛⬛
⬛⬜⬜⬜⬜⬜⬛⬜⬜⬛⬜⬜⬜⬜⬜⬜⬜⬜⬜🟥🟥⬛
⬛⬜⬜⬜⬜⬜⬛⬜⬜⬛⬜⬜⬜⬜⬜⬜⬜⬜⬜🟥🟥⬛
⬛⬛⬛⬛⬛⬛⬛⬛⬛⬛⬛⬛⬛⬛⬛⬛⬛⬛⬛⬛⬛⬛


⬛⬛⬛⬛⬛⬛⬛⬛⬛⬛⬛⬛⬛⬛⬛⬛⬛⬛⬛⬛⬛⬛
⬛🟩🟩⬜⬜⬜⬜⬜⬜⬜⬜⬜⬜⬜⬜⬜⬜⬜⬜⬜⬜⬛
⬛🟩🟩⬜⬜⬜⬜⬜⬜⬜⬜⬜⬜⬜⬜⬜⬜⬜⬜⬜⬜⬛
⬛⬜⬜⬛⬛⬛⬛⬛⬛⬛⬛⬛⬛⬜⬜⬛⬛⬛⬛⬜⬜⬛
⬛⬜⬜⬜⬜⬜⬜⬜⬜⬜⬜⬜⬛⬜⬜⬜⬜⬜⬛⬜⬜⬛
⬛⬜⬜⬜⬜⬜⬜⬜⬜⬜⬜⬜⬛⬜⬜⬜⬜⬜⬛⬜⬜⬛
⬛⬜⬜⬛⬛⬛⬛⬜⬜⬛⬛⬛⬛⬛⬛⬛⬜⬜⬛⬛⬛⬛
⬛⬜⬜⬜⬜⬜⬛⬜⬜⬜⬜⬜⬜⬜⬜⬛⬜⬜⬜⬜⬜⬛
⬛⬜⬜⬜⬜⬜⬛⬜⬜⬜⬜⬜⬜⬜⬜⬛⬜⬜⬜⬜⬜⬛
⬛⬜⬜⬛⬛⬛⬛⬛⬛⬛⬜⬜⬛⬜⬜⬛⬛⬛⬛⬛⬛⬛
⬛⬜⬜⬜⬜⬜⬜⬜⬜⬛⬜⬜⬛⬜⬜⬜⬜⬜⬜⬜⬜⬛
⬛⬜⬜⬜⬜⬜⬜⬜⬜⬛⬜⬜⬛⬜⬜⬜⬜⬜⬜⬜⬜⬛
⬛⬜⬜⬛⬛⬛⬛⬜⬜⬛⬛⬛⬛⬛⬛⬛⬜⬜⬛⬜⬜⬛
⬛⬜⬜⬜⬜⬜⬛⬜⬜⬜⬜⬜⬜⬜⬜⬛⬜⬜⬛⬜⬜⬛
⬛⬜⬜⬜⬜⬜⬛⬜⬜⬜⬜⬜⬜⬜⬜⬛⬜⬜⬛⬜⬜⬛
⬛⬜⬜⬛⬛⬛⬛⬛⬛⬛⬛⬛⬛⬜⬜⬛⬜⬜⬛⬜⬜⬛
⬛⬜⬜⬜⬜⬜⬜⬜⬜⬜⬜⬜⬛⬜⬜⬛⬜⬜⬛⬜⬜⬛
⬛⬜⬜⬜⬜⬜⬜⬜⬜⬜⬜⬜⬛⬜⬜⬛⬜⬜⬛⬜⬜⬛
⬛⬜⬜⬛⬜⬜⬛⬜⬜⬛⬛⬛⬛⬛⬛⬛⬜⬜⬛⬛⬛⬛
⬛⬜⬜⬛⬜⬜⬛⬜⬜⬜⬜⬜⬜⬜⬜⬛⬜⬜⬜🟥🟥⬛
⬛⬜⬜⬛⬜⬜⬛⬜⬜⬜⬜⬜⬜⬜⬜⬛⬜⬜⬜🟥🟥⬛
⬛⬛⬛⬛⬛⬛⬛⬛⬛⬛⬛⬛⬛⬛⬛⬛⬛⬛⬛⬛⬛⬛


⬛⬛⬛⬛⬛⬛⬛⬛⬛⬛⬛⬛⬛⬛⬛⬛⬛⬛⬛⬛⬛⬛
⬛🟩🟩⬜⬜⬜⬜⬜⬜⬜⬜⬜⬜⬜⬜⬜⬜⬜⬜⬜⬜⬛
⬛🟩🟩⬜⬜⬜⬜⬜⬜⬜⬜⬜⬜⬜⬜⬜⬜⬜⬜⬜⬜⬛
⬛⬜⬜⬛⬜⬜⬛⬜⬜⬛⬛⬛⬛⬛⬛⬛⬜⬜⬛⬛⬛⬛
⬛⬜⬜⬛⬜⬜⬛⬜⬜⬜⬜⬜⬜⬜⬜⬛⬜⬜⬜⬜⬜⬛
⬛⬜⬜⬛⬜⬜⬛⬜⬜⬜⬜⬜⬜⬜⬜⬛⬜⬜⬜⬜⬜⬛
⬛⬜⬜⬛⬛⬛⬛⬜⬜⬛⬛⬛⬛⬛⬛⬛⬜⬜⬛⬜⬜⬛
⬛⬜⬜⬜⬜⬜⬛⬜⬜⬜⬜⬜⬜⬜⬜⬛⬜⬜⬛⬜⬜⬛
⬛⬜⬜⬜⬜⬜⬛⬜⬜⬜⬜⬜⬜⬜⬜⬛⬜⬜⬛⬜⬜⬛
⬛⬜⬜⬛⬜⬜⬛⬛⬛⬛⬛⬛⬛⬜⬜⬛⬜⬜⬛⬛⬛⬛
⬛⬜⬜⬛⬜⬜⬜⬜⬜⬜⬜⬜⬛⬜⬜⬛⬜⬜⬜⬜⬜⬛
⬛⬜⬜⬛⬜⬜⬜⬜⬜⬜⬜⬜⬛⬜⬜⬛⬜⬜⬜⬜⬜⬛
⬛⬜⬜⬛⬛⬛⬛⬜⬜⬛⬛⬛⬛⬛⬛⬛⬜⬜⬛⬛⬛⬛
⬛⬜⬜⬜⬜⬜⬛⬜⬜⬜⬜⬜⬜⬜⬜⬛⬜⬜⬜⬜⬜⬛
⬛⬜⬜⬜⬜⬜⬛⬜⬜⬜⬜⬜⬜⬜⬜⬛⬜⬜⬜⬜⬜⬛
⬛⬜⬜⬛⬛⬛⬛⬛⬛⬛⬛⬛⬛⬜⬜⬛⬛⬛⬛⬜⬜⬛
⬛⬜⬜⬜⬜⬜⬜⬜⬜⬜⬜⬜⬛⬜⬜⬜⬜⬜⬛⬜⬜⬛
⬛⬜⬜⬜⬜⬜⬜⬜⬜⬜⬜⬜⬛⬜⬜⬜⬜⬜⬛⬜⬜⬛
⬛⬜⬜⬛⬜⬜⬛⬜⬜⬛⬜⬜⬛⬛⬛⬛⬛⬛⬛⬜⬜⬛
⬛⬜⬜⬛⬜⬜⬛⬜⬜⬛⬜⬜⬜⬜⬜⬜⬜⬜⬛🟥🟥⬛
⬛⬜⬜⬛⬜⬜⬛⬜⬜⬛⬜⬜⬜⬜⬜⬜⬜⬜⬛🟥🟥⬛
⬛⬛⬛⬛⬛⬛⬛⬛⬛⬛⬛⬛⬛⬛⬛⬛⬛⬛⬛⬛⬛⬛


⬛⬛⬛⬛⬛⬛⬛⬛⬛⬛⬛⬛⬛⬛⬛⬛⬛⬛⬛⬛⬛⬛
⬛🟩🟩⬜⬜⬜⬜⬜⬜⬜⬜⬜⬜⬜⬜⬜⬜⬜⬜⬜⬜⬛
⬛🟩🟩⬜⬜⬜⬜⬜⬜⬜⬜⬜⬜⬜⬜⬜⬜⬜⬜⬜⬜⬛
⬛⬜⬜⬛⬜⬜⬛⬛⬛⬛⬛⬛⬛⬛⬛⬛⬜⬜⬛⬛⬛⬛
⬛⬜⬜⬛⬜⬜⬜⬜⬜⬜⬜⬜⬜⬜⬜⬛⬜⬜⬜⬜⬜⬛
⬛⬜⬜⬛⬜⬜⬜⬜⬜⬜⬜⬜⬜⬜⬜⬛⬜⬜⬜⬜⬜⬛
⬛⬜⬜⬛⬛⬛⬛⬜⬜⬛⬜⬜⬛⬛⬛⬛⬛⬛⬛⬜⬜⬛
⬛⬜⬜⬜⬜⬜⬛⬜⬜⬛⬜⬜⬜⬜⬜⬜⬜⬜⬛⬜⬜⬛
⬛⬜⬜⬜⬜⬜⬛⬜⬜⬛⬜⬜⬜⬜⬜⬜⬜⬜⬛⬜⬜⬛
⬛⬜⬜⬛⬛⬛⬛⬜⬜⬛⬜⬜⬛⬛⬛⬛⬛⬛⬛⬛⬛⬛
⬛⬜⬜⬜⬜⬜⬛⬜⬜⬛⬜⬜⬜⬜⬜⬜⬜⬜⬜⬜⬜⬛
⬛⬜⬜⬜⬜⬜⬛⬜⬜⬛⬜⬜⬜⬜⬜⬜⬜⬜⬜⬜⬜⬛
⬛⬜⬜⬛⬜⬜⬛⬜⬜⬛⬜⬜⬛⬜⬜⬛⬛⬛⬛⬛⬛⬛
⬛⬜⬜⬛⬜⬜⬛⬜⬜⬛⬜⬜⬛⬜⬜⬜⬜⬜⬜⬜⬜⬛
⬛⬜⬜⬛⬜⬜⬛⬜⬜⬛⬜⬜⬛⬜⬜⬜⬜⬜⬜⬜⬜⬛
⬛⬜⬜⬛⬛⬛⬛⬛⬛⬛⬛⬛⬛⬛⬛⬛⬜⬜⬛⬜⬜⬛
⬛⬜⬜⬜⬜⬜⬜⬜⬜⬜⬜⬜⬜⬜⬜⬛⬜⬜⬛⬜⬜⬛
⬛⬜⬜⬜⬜⬜⬜⬜⬜⬜⬜⬜⬜⬜⬜⬛⬜⬜⬛⬜⬜⬛
⬛⬜⬜⬛⬜⬜⬛⬛⬛⬛⬛⬛⬛⬜⬜⬛⬜⬜⬛⬜⬜⬛
⬛⬜⬜⬛⬜⬜⬜⬜⬜⬜⬜⬜⬛⬜⬜⬛⬜⬜⬛🟥🟥⬛
⬛⬜⬜⬛⬜⬜⬜⬜⬜⬜⬜⬜⬛⬜⬜⬛⬜⬜⬛🟥🟥⬛
⬛⬛⬛⬛⬛⬛⬛⬛⬛⬛⬛⬛⬛⬛⬛⬛⬛⬛⬛⬛⬛⬛

🟩
⬛⬛⬛⬛⬛⬛⬛⬛⬛⬛⬛⬛⬛⬛⬛⬛⬛⬛⬛⬛⬛⬛
⬛🟩🟩⬜⬜⬜⬜⬜⬜⬜⬜⬜⬜⬜⬜⬜⬜⬜⬜⬜⬜⬛
⬛🟩🟩⬜⬜⬜⬜⬜⬜⬜⬜⬜⬜⬜⬜⬜⬜⬜⬜⬜⬜⬛
⬛⬜⬜⬛⬛⬛⬛⬜⬜⬛⬜⬜⬛⬛⬛⬛⬜⬜⬛⬛⬛⬛
⬛⬜⬜⬜⬜⬜⬛⬜⬜⬛⬜⬜⬜⬜⬜⬛⬜⬜⬜⬜⬜⬛
⬛⬜⬜⬜⬜⬜⬛⬜⬜⬛⬜⬜⬜⬜⬜⬛⬜⬜⬜⬜⬜⬛
⬛⬜⬜⬛⬜⬜⬛⬜⬜⬛⬛⬛⬛⬛⬛⬛⬜⬜⬛⬜⬜⬛
⬛⬜⬜⬛⬜⬜⬛⬜⬜⬜⬜⬜⬜⬜⬜⬛⬜⬜⬛⬜⬜⬛
⬛⬜⬜⬛⬜⬜⬛⬜⬜⬜⬜⬜⬜⬜⬜⬛⬜⬜⬛⬜⬜⬛
⬛⬜⬜⬛⬜⬜⬛⬛⬛⬛⬜⬜⬛⬜⬜⬛⬛⬛⬛⬜⬜⬛
⬛⬜⬜⬛⬜⬜⬜⬜⬜⬛⬜⬜⬛⬜⬜⬜⬜⬜⬛⬜⬜⬛
⬛⬜⬜⬛⬜⬜⬜⬜⬜⬛⬜⬜⬛⬜⬜⬜⬜⬜⬛⬜⬜⬛
⬛⬜⬜⬛⬜⬜⬛⬜⬜⬛⬜⬜⬛⬜⬜⬛⬛⬛⬛⬜⬜⬛
⬛⬜⬜⬛⬜⬜⬛⬜⬜⬛⬜⬜⬛⬜⬜⬜⬜⬜⬛⬜⬜⬛
⬛⬜⬜⬛⬜⬜⬛⬜⬜⬛⬜⬜⬛⬜⬜⬜⬜⬜⬛⬜⬜⬛
⬛⬜⬜⬛⬜⬜⬛⬛⬛⬛⬜⬜⬛⬛⬛⬛⬛⬛⬛⬛⬛⬛
⬛⬜⬜⬛⬜⬜⬜⬜⬜⬛⬜⬜⬜⬜⬜⬜⬜⬜⬜⬜⬜⬛
⬛⬜⬜⬛⬜⬜⬜⬜⬜⬛⬜⬜⬜⬜⬜⬜⬜⬜⬜⬜⬜⬛
⬛⬜⬜⬛⬛⬛⬛⬛⬛⬛⬛⬛⬛⬜⬜⬛⬛⬛⬛⬜⬜⬛
⬛⬜⬜⬜⬜⬜⬜⬜⬜⬜⬜⬜⬛⬜⬜⬜⬜⬜⬛🟥🟥⬛
⬛⬜⬜⬜⬜⬜⬜⬜⬜⬜⬜⬜⬛⬜⬜⬜⬜⬜⬛🟥🟥⬛
⬛⬛⬛⬛⬛⬛⬛⬛⬛⬛⬛⬛⬛⬛⬛⬛⬛⬛⬛⬛⬛⬛

⬛