
⬛⬛⬛⬛⬛⬛⬛⬛⬛⬛⬛⬛⬛⬛⬛⬛
⬛🟩🟩⬛⬜⬜⬛⬜⬜⬜⬜⬜⬛⬜⬜⬛
⬛🟩🟩⬛⬜⬜⬛⬜⬜⬜⬜⬜⬛⬜⬜⬛
⬛⬛⬛⬛⬜⬜⬛⬜⬜⬛⬛⬛⬛⬜⬜⬛
⬛⬜⬜⬜⬜⬜⬛⬜⬜⬛⬜⬜⬛⬜⬜⬛
⬛⬜⬜⬜⬜⬜⬛⬜⬜⬛⬜⬜⬛⬜⬜⬛
⬛⬜⬜⬛⬜⬜⬛⬜⬜⬛⬜⬜⬛⬜⬜⬛
⬛⬜⬜⬜⬜⬜⬛⬜⬜⬜⬜⬜⬜⬜⬜⬛
⬛⬜⬜⬜⬜⬜⬛⬜⬜⬜⬜⬜⬜⬜⬜⬛
⬛⬜⬜⬛⬛⬛⬛⬜⬜⬛⬜⬜⬛⬛⬛⬛
⬛⬜⬜⬛⬜⬜⬜⬜⬜⬛⬜⬜⬜⬜⬜⬛
⬛⬜⬜⬛⬜⬜⬜⬜⬜⬛⬜⬜⬜⬜⬜⬛
⬛⬛⬛⬛⬜⬜⬛⬜⬜⬛⬜⬜⬛⬜⬜⬛
⬛⬜⬜⬜⬜⬜⬜⬜⬜⬜⬜⬜⬜🟥🟥⬛
⬛⬜⬜⬜⬜⬜⬜⬜⬜⬜⬜⬜⬜🟥🟥⬛
⬛⬛⬛⬛⬛⬛⬛⬛⬛⬛⬛⬛⬛⬛⬛⬛


⬛⬛⬛⬛⬛⬛⬛⬛⬛⬛⬛⬛⬛⬛⬛⬛
⬛🟩🟩⬛⬜⬜⬜⬜⬜⬛⬜⬜⬛⬜⬜⬛
⬛🟩🟩⬛⬜⬜⬜⬜⬜⬛⬜⬜⬛⬜⬜⬛
⬛⬛⬛⬛⬜⬜⬛⬜⬜⬛⬜⬜⬛⬜⬜⬛
⬛⬜⬜⬜⬜⬜⬜⬜⬜⬜⬜⬜⬜⬜⬜⬛
⬛⬜⬜⬜⬜⬜⬜⬜⬜⬜⬜⬜⬜⬜⬜⬛
⬛⬜⬜⬛⬛⬛⬛⬜⬜⬛⬛⬛⬛⬛⬛⬛
⬛⬜⬜⬜⬜⬜⬜⬜⬜⬛⬜⬜⬜⬜⬜⬛
⬛⬜⬜⬜⬜⬜⬜⬜⬜⬛⬜⬜⬜⬜⬜⬛
⬛⬜⬜⬛⬛⬛⬛⬛⬛⬛⬜⬜⬛⬜⬜⬛
⬛⬜⬜⬛⬜⬜⬜⬜⬜⬛⬜⬜⬜⬜⬜⬛
⬛⬜⬜⬛⬜⬜⬜⬜⬜⬛⬜⬜⬜⬜⬜⬛
⬛⬜⬜⬛⬜⬜⬛⬛⬛⬛⬜⬜⬛⬜⬜⬛
⬛⬜⬜⬜⬜⬜⬜⬜⬜⬜⬜⬜⬜🟥🟥⬛
⬛⬜⬜⬜⬜⬜⬜⬜⬜⬜⬜⬜⬜🟥🟥⬛
⬛⬛⬛⬛⬛⬛⬛⬛⬛⬛⬛⬛⬛⬛⬛⬛


⬛⬛⬛⬛⬛⬛⬛⬛⬛⬛⬛⬛⬛⬛⬛⬛
⬛🟩🟩⬛⬜⬜⬜⬜⬜⬜⬜⬜⬜⬜⬜⬛
⬛🟩🟩⬛⬜⬜⬜⬜⬜⬜⬜⬜⬜⬜⬜⬛
⬛⬛⬛⬛⬜⬜⬛⬛⬛⬛⬜⬜⬛⬛⬛⬛
⬛⬜⬜⬛⬜⬜⬛⬜⬜⬜⬜⬜⬜⬜⬜⬛
⬛⬜⬜⬛⬜⬜⬛⬜⬜⬜⬜⬜⬜⬜⬜⬛
⬛⬜⬜⬛⬜⬜⬛⬜⬜⬛⬜⬜⬛⬜⬜⬛
⬛⬜⬜⬜⬜⬜⬛⬜⬜⬜⬜⬜⬜⬜⬜⬛
⬛⬜⬜⬜⬜⬜⬛⬜⬜⬜⬜⬜⬜⬜⬜⬛
⬛⬛⬛⬛⬜⬜⬛⬜⬜⬛⬜⬜⬛⬛⬛⬛
⬛⬜⬜⬜⬜⬜⬜⬜⬜⬜⬜⬜⬜⬜⬜⬛
⬛⬜⬜⬜⬜⬜⬜⬜⬜⬜⬜⬜⬜⬜⬜⬛
⬛⬜⬜⬛⬛⬛⬛⬛⬛⬛⬛⬛⬛⬛⬛⬛
⬛⬜⬜⬜⬜⬜⬜⬜⬜⬜⬜⬜⬜🟥🟥⬛
⬛⬜⬜⬜⬜⬜⬜⬜⬜⬜⬜⬜⬜🟥🟥⬛
⬛⬛⬛⬛⬛⬛⬛⬛⬛⬛⬛⬛⬛⬛⬛⬛


⬛⬛⬛⬛⬛⬛⬛⬛⬛⬛⬛⬛⬛⬛⬛⬛
⬛🟩🟩⬛⬜⬜⬛⬜⬜⬜⬜⬜⬜⬜⬜⬛
⬛🟩🟩⬛⬜⬜⬛⬜⬜⬜⬜⬜⬜⬜⬜⬛
⬛⬛⬛⬛⬜⬜⬛⬜⬜⬛⬛⬛⬛⬜⬜⬛
⬛⬜⬜⬜⬜⬜⬛⬜⬜⬛⬜⬜⬜⬜⬜⬛
⬛⬜⬜⬜⬜⬜⬛⬜⬜⬛⬜⬜⬜⬜⬜⬛
⬛⬛⬛⬛⬜⬜⬛⬜⬜⬛⬜⬜⬛⬛⬛⬛
⬛⬜⬜⬜⬜⬜⬜⬜⬜⬛⬜⬜⬜⬜⬜⬛
⬛⬜⬜⬜⬜⬜⬜⬜⬜⬛⬜⬜⬜⬜⬜⬛
⬛⬛⬛⬛⬛⬛⬛⬜⬜⬛⬜⬜⬛⬜⬜⬛
⬛⬜⬜⬛⬜⬜⬛⬜⬜⬜⬜⬜⬜⬜⬜⬛
⬛⬜⬜⬛⬜⬜⬛⬜⬜⬜⬜⬜⬜⬜⬜⬛
⬛⬜⬜⬛⬜⬜⬛⬜⬜⬛⬜⬜⬛⬜⬜⬛
⬛⬜⬜⬛⬜⬜⬜⬜⬜⬛⬜⬜⬜🟥🟥⬛
⬛⬜⬜⬛⬜⬜⬜⬜⬜⬛⬜⬜⬜🟥🟥⬛
⬛⬛⬛⬛⬛⬛⬛⬛⬛⬛⬛⬛⬛⬛⬛⬛


⬛⬛⬛⬛⬛⬛⬛⬛⬛⬛⬛⬛⬛⬛⬛⬛
⬛🟩🟩⬛⬜⬜⬛⬜⬜⬛⬜⬜⬜⬜⬜⬛
⬛🟩🟩⬛⬜⬜⬛⬜⬜⬛⬜⬜⬜⬜⬜⬛
⬛⬜⬜⬛⬜⬜⬛⬜⬜⬛⬜⬜⬛⬜⬜⬛
⬛⬜⬜⬜⬜⬜⬜⬜⬜⬜⬜⬜⬜⬜⬜⬛
⬛⬜⬜⬜⬜⬜⬜⬜⬜⬜⬜⬜⬜⬜⬜⬛
⬛⬜⬜⬛⬛⬛⬛⬛⬛⬛⬛⬛⬛⬜⬜⬛
⬛⬜⬜⬜⬜⬜⬜⬜⬜⬜⬜⬜⬜⬜⬜⬛
⬛⬜⬜⬜⬜⬜⬜⬜⬜⬜⬜⬜⬜⬜⬜⬛
⬛⬜⬜⬛⬛⬛⬛⬜⬜⬛⬜⬜⬛⬛⬛⬛
⬛⬜⬜⬛⬜⬜⬜⬜⬜⬛⬜⬜⬜⬜⬜⬛
⬛⬜⬜⬛⬜⬜⬜⬜⬜⬛⬜⬜⬜⬜⬜⬛
⬛⬛⬛⬛⬜⬜⬛⬜⬜⬛⬜⬜⬛⬜⬜⬛
⬛⬜⬜⬛⬜⬜⬜⬜⬜⬛⬜⬜⬛🟥🟥⬛
⬛⬜⬜⬛⬜⬜⬜⬜⬜⬛⬜⬜⬛🟥🟥⬛
⬛⬛⬛⬛⬛⬛⬛⬛⬛⬛⬛⬛⬛⬛⬛⬛


⬛⬛⬛⬛⬛⬛⬛⬛⬛⬛⬛⬛⬛⬛⬛⬛
⬛🟩🟩⬜⬜⬜⬜⬜⬜⬜⬜⬜⬜⬜⬜⬛
⬛🟩🟩⬜⬜⬜⬜⬜⬜⬜⬜⬜⬜⬜⬜⬛
⬛⬛⬛⬛⬛⬛⬛⬛⬛⬛⬛⬛⬛⬜⬜⬛
⬛⬜⬜⬛⬜⬜⬛⬜⬜⬜⬜⬜⬜⬜⬜⬛
⬛⬜⬜⬛⬜⬜⬛⬜⬜⬜⬜⬜⬜⬜⬜⬛
⬛⬛⬛⬛⬜⬜⬛⬜⬜⬛⬜⬜⬛⬜⬜⬛
⬛⬜⬜⬜⬜⬜⬜⬜⬜⬜⬜⬜⬜⬜⬜⬛
⬛⬜⬜⬜⬜⬜⬜⬜⬜⬜⬜⬜⬜⬜⬜⬛
⬛⬜⬜⬛⬜⬜⬛⬛⬛⬛⬜⬜⬛⬛⬛⬛
⬛⬜⬜⬜⬜⬜⬜⬜⬜⬜⬜⬜⬜⬜⬜⬛
⬛⬜⬜⬜⬜⬜⬜⬜⬜⬜⬜⬜⬜⬜⬜⬛
⬛⬜⬜⬛⬛⬛⬛⬛⬛⬛⬛⬛⬛⬛⬛⬛
⬛⬜⬜⬜⬜⬜⬜⬜⬜⬜⬜⬜⬜🟥🟥⬛
⬛⬜⬜⬜⬜⬜⬜⬜⬜⬜⬜⬜⬜🟥🟥⬛
⬛⬛⬛⬛⬛⬛⬛⬛⬛⬛⬛⬛⬛⬛⬛⬛


⬛⬛⬛⬛⬛⬛⬛⬛⬛⬛⬛⬛⬛⬛⬛⬛
⬛🟩🟩⬜⬜⬜⬛⬜⬜⬜⬜⬜⬛⬜⬜⬛
⬛🟩🟩⬜⬜⬜⬛⬜⬜⬜⬜⬜⬛⬜⬜⬛
⬛⬜⬜⬛⬛⬛⬛⬜⬜⬛⬛⬛⬛⬜⬜⬛
⬛⬜⬜⬛⬜⬜⬜⬜⬜⬛⬜⬜⬛⬜⬜⬛
⬛⬜⬜⬛⬜⬜⬜⬜⬜⬛⬜⬜⬛⬜⬜⬛
⬛⬜⬜⬛⬜⬜⬛⬛⬛⬛⬜⬜⬛⬜⬜⬛
⬛⬜⬜⬜⬜⬜⬜⬜⬜⬛⬜⬜⬛⬜⬜⬛
⬛⬜⬜⬜⬜⬜⬜⬜⬜⬛⬜⬜⬛⬜⬜⬛
⬛⬛⬛⬛⬜⬜⬛⬜⬜⬛⬜⬜⬛⬜⬜⬛
⬛⬜⬜⬜⬜⬜⬜⬜⬜⬜⬜⬜⬛⬜⬜⬛
⬛⬜⬜⬜⬜⬜⬜⬜⬜⬜⬜⬜⬛⬜⬜⬛
⬛⬜⬜⬛⬛⬛⬛⬛⬛⬛⬛⬛⬛⬜⬜⬛
⬛⬜⬜⬜⬜⬜⬜⬜⬜⬜⬜⬜⬛🟥🟥⬛
⬛⬜⬜⬜⬜⬜⬜⬜⬜⬜⬜⬜⬛🟥🟥⬛
⬛⬛⬛⬛⬛⬛⬛⬛⬛⬛⬛⬛⬛⬛⬛⬛


⬛⬛⬛⬛⬛⬛⬛⬛⬛⬛⬛⬛⬛⬛⬛⬛
⬛🟩🟩⬜⬜⬜⬜⬜⬜⬛⬜⬜⬛⬜⬜⬛
⬛🟩🟩⬜⬜⬜⬜⬜⬜⬛⬜⬜⬛⬜⬜⬛
⬛⬜⬜⬛⬜⬜⬛⬜⬜⬛⬜⬜⬛⬜⬜⬛
⬛⬜⬜⬛⬜⬜⬛⬜⬜⬜⬜⬜⬜⬜⬜⬛
⬛⬜⬜⬛⬜⬜⬛⬜⬜⬜⬜⬜⬜⬜⬜⬛
⬛⬜⬜⬛⬜⬜⬛⬜⬜⬛⬛⬛⬛⬛⬛⬛
⬛⬜⬜⬛⬜⬜⬛⬜⬜⬜⬜⬜⬜⬜⬜⬛
⬛⬜⬜⬛⬜⬜⬛⬜⬜⬜⬜⬜⬜⬜⬜⬛
⬛⬜⬜⬛⬜⬜⬛⬜⬜⬛⬜⬜⬛⬛⬛⬛
⬛⬜⬜⬜⬜⬜⬛⬜⬜⬜⬜⬜⬜⬜⬜⬛
⬛⬜⬜⬜⬜⬜⬛⬜⬜⬜⬜⬜⬜⬜⬜⬛
⬛⬛⬛⬛⬛⬛⬛⬜⬜⬛⬜⬜⬛⬜⬜⬛
⬛⬜⬜⬜⬜⬜⬜⬜⬜⬛⬜⬜⬛🟥🟥⬛
⬛⬜⬜⬜⬜⬜⬜⬜⬜⬛⬜⬜⬛🟥🟥⬛
⬛⬛⬛⬛⬛⬛⬛⬛⬛⬛⬛⬛⬛⬛⬛⬛


⬛⬛⬛⬛⬛⬛⬛⬛⬛⬛⬛⬛⬛⬛⬛⬛
⬛🟩🟩⬜⬜⬜⬜⬜⬜⬜⬜⬜⬛⬜⬜⬛
⬛🟩🟩⬜⬜⬜⬜⬜⬜⬜⬜⬜⬛⬜⬜⬛
⬛⬜⬜⬛⬜⬜⬛⬛⬛⬛⬜⬜⬛⬜⬜⬛
⬛⬜⬜⬜⬜⬜⬜⬜⬜⬛⬜⬜⬜⬜⬜⬛
⬛⬜⬜⬜⬜⬜⬜⬜⬜⬛⬜⬜⬜⬜⬜⬛
⬛⬜⬜⬛⬜⬜⬛⬛⬛⬛⬜⬜⬛⬜⬜⬛
⬛⬜⬜⬜⬜⬜⬜⬜⬜⬛⬜⬜⬛⬜⬜⬛
⬛⬜⬜⬜⬜⬜⬜⬜⬜⬛⬜⬜⬛⬜⬜⬛
⬛⬜⬜⬛⬛⬛⬛⬛⬛⬛⬜⬜⬛⬜⬜⬛
⬛⬜⬜⬜⬜⬜⬜⬜⬜⬛⬜⬜⬜⬜⬜⬛
⬛⬜⬜⬜⬜⬜⬜⬜⬜⬛⬜⬜⬜⬜⬜⬛
⬛⬜⬜⬛⬛⬛⬛⬜⬜⬛⬜⬜⬛⬜⬜⬛
⬛⬜⬜⬜⬜⬜⬜⬜⬜⬜⬜⬜⬜🟥🟥⬛
⬛⬜⬜⬜⬜⬜⬜⬜⬜⬜⬜⬜⬜🟥🟥⬛
⬛⬛⬛⬛⬛⬛⬛⬛⬛⬛⬛⬛⬛⬛⬛⬛


⬛⬛⬛⬛⬛⬛⬛⬛⬛⬛⬛⬛⬛⬛⬛⬛
⬛🟩🟩⬜⬜⬜⬛⬜⬜⬜⬜⬜⬜⬜⬜⬛
⬛🟩🟩⬜⬜⬜⬛⬜⬜⬜⬜⬜⬜⬜⬜⬛
⬛⬜⬜⬛⬜⬜⬛⬜⬜⬛⬛⬛⬛⬛⬛⬛
⬛⬜⬜⬜⬜⬜⬛⬜⬜⬜⬜⬜⬛⬜⬜⬛
⬛⬜⬜⬜⬜⬜⬛⬜⬜⬜⬜⬜⬛⬜⬜⬛
⬛⬛⬛⬛⬛⬛⬛⬜⬜⬛⬛⬛⬛⬜⬜⬛
⬛⬜⬜⬜⬜⬜⬛⬜⬜⬜⬜⬜⬜⬜⬜⬛
⬛⬜⬜⬜⬜⬜⬛⬜⬜⬜⬜⬜⬜⬜⬜⬛
⬛⬛⬛⬛⬛⬛⬛⬜⬜⬛⬛⬛⬛⬛⬛⬛
⬛⬜⬜⬜⬜⬜⬜⬜⬜⬛⬜⬜⬛⬜⬜⬛
⬛⬜⬜⬜⬜⬜⬜⬜⬜⬛⬜⬜⬛⬜⬜⬛
⬛⬛⬛⬛⬜⬜⬛⬜⬜⬛⬜⬜⬛⬜⬜⬛
⬛⬜⬜⬜⬜⬜⬜⬜⬜⬜⬜⬜⬛🟥🟥⬛
⬛⬜⬜⬜⬜⬜⬜⬜⬜⬜⬜⬜⬛🟥🟥⬛
⬛⬛⬛⬛⬛⬛⬛⬛⬛⬛⬛⬛⬛⬛⬛⬛

