
⬛⬛⬛⬛⬛⬛⬛⬛⬛⬛⬛⬛⬛⬛⬛⬛⬛⬛⬛⬛⬛⬛
⬛🟩🟩⬜⬜⬜⬜⬜⬜⬜⬜⬜⬜⬜⬜⬜⬜⬜⬜⬜⬜⬛
⬛🟩🟩⬜⬜⬜⬜⬜⬜⬜⬜⬜⬜⬜⬜⬜⬜⬜⬜⬜⬜⬛
⬛⬜⬜⬛⬛⬛⬛⬜⬜⬛⬜⬜⬛⬜⬜⬛⬛⬛⬛⬛⬛⬛
⬛⬜⬜⬜⬜⬜⬛⬜⬜⬛⬜⬜⬛⬜⬜⬜⬜⬜⬜⬜⬜⬛
⬛⬜⬜⬜⬜⬜⬛⬜⬜⬛⬜⬜⬛⬜⬜⬜⬜⬜⬜⬜⬜⬛
⬛⬜⬜⬛⬜⬜⬛⬛⬛⬛⬜⬜⬛⬛⬛⬛⬜⬜⬛⬜⬜⬛
⬛⬜⬜⬛⬜⬜⬜⬜⬜⬛⬜⬜⬜⬜⬜⬛⬜⬜⬛⬜⬜⬛
⬛⬜⬜⬛⬜⬜⬜⬜⬜⬛⬜⬜⬜⬜⬜⬛⬜⬜⬛⬜⬜⬛
⬛⬜⬜⬛⬜⬜⬛⬜⬜⬛⬛⬛⬛⬜⬜⬛⬜⬜⬛⬛⬛⬛
⬛⬜⬜⬛⬜⬜⬛⬜⬜⬜⬜⬜⬛⬜⬜⬛⬜⬜⬜⬜⬜⬛
⬛⬜⬜⬛⬜⬜⬛⬜⬜⬜⬜⬜⬛⬜⬜⬛⬜⬜⬜⬜⬜⬛
⬛⬜⬜⬛⬜⬜⬛⬜⬜⬛⬜⬜⬛⬜⬜⬛⬛⬛⬛⬜⬜⬛
⬛⬜⬜⬛⬜⬜⬛⬜⬜⬛⬜⬜⬛⬜⬜⬜⬜⬜⬛⬜⬜⬛
⬛⬜⬜⬛⬜⬜⬛⬜⬜⬛⬜⬜⬛⬜⬜⬜⬜⬜⬛⬜⬜⬛
⬛⬜⬜⬛⬛⬛⬛⬛⬛⬛⬜⬜⬛⬛⬛⬛⬛⬛⬛⬛⬛⬛
⬛⬜⬜⬜⬜⬜⬜⬜⬜⬛⬜⬜⬜⬜⬜⬜⬜⬜⬜⬜⬜⬛
⬛⬜⬜⬜⬜⬜⬜⬜⬜⬛⬜⬜⬜⬜⬜⬜⬜⬜⬜⬜⬜⬛
⬛⬜⬜⬛⬜⬜⬛⬛⬛⬛⬛⬛⬛⬜⬜⬛⬛⬛⬛⬜⬜⬛
⬛⬜⬜⬛⬜⬜⬜⬜⬜⬜⬜⬜⬛⬜⬜⬜⬜⬜⬛🟥🟥⬛
⬛⬜⬜⬛⬜⬜⬜⬜⬜⬜⬜⬜⬛⬜⬜⬜⬜⬜⬛🟥🟥⬛
⬛⬛⬛⬛⬛⬛⬛⬛⬛⬛⬛⬛⬛⬛⬛⬛⬛⬛⬛⬛⬛⬛


⬛⬛⬛⬛⬛⬛⬛⬛⬛⬛⬛⬛⬛⬛⬛⬛⬛⬛⬛⬛⬛⬛
⬛🟩🟩⬜⬜⬜⬜⬜⬜⬜⬜⬜⬜⬜⬜⬜⬜⬜⬜⬜⬜⬛
⬛🟩🟩⬜⬜⬜⬜⬜⬜⬜⬜⬜⬜⬜⬜⬜⬜⬜⬜⬜⬜⬛
⬛⬜⬜⬛⬜⬜⬛⬜⬜⬛⬜⬜⬛⬜⬜⬛⬜⬜⬛⬛⬛⬛
⬛⬜⬜⬛⬜⬜⬛⬜⬜⬛⬜⬜⬛⬜⬜⬛⬜⬜⬜⬜⬜⬛
⬛⬜⬜⬛⬜⬜⬛⬜⬜⬛⬜⬜⬛⬜⬜⬛⬜⬜⬜⬜⬜⬛
⬛⬜⬜⬛⬛⬛⬛⬛⬛⬛⬛⬛⬛⬜⬜⬛⬛⬛⬛⬛⬛⬛
⬛⬜⬜⬜⬜⬜⬜⬜⬜⬜⬜⬜⬛⬜⬜⬜⬜⬜⬜⬜⬜⬛
⬛⬜⬜⬜⬜⬜⬜⬜⬜⬜⬜⬜⬛⬜⬜⬜⬜⬜⬜⬜⬜⬛
⬛⬜⬜⬛⬜⬜⬛⬛⬛⬛⬛⬛⬛⬜⬜⬛⬛⬛⬛⬜⬜⬛
⬛⬜⬜⬛⬜⬜⬜⬜⬜⬜⬜⬜⬛⬜⬜⬜⬜⬜⬛⬜⬜⬛
⬛⬜⬜⬛⬜⬜⬜⬜⬜⬜⬜⬜⬛⬜⬜⬜⬜⬜⬛⬜⬜⬛
⬛⬜⬜⬛⬜⬜⬛⬜⬜⬛⬛⬛⬛⬜⬜⬛⬛⬛⬛⬜⬜⬛
⬛⬜⬜⬛⬜⬜⬛⬜⬜⬜⬜⬜⬛⬜⬜⬜⬜⬜⬛⬜⬜⬛
⬛⬜⬜⬛⬜⬜⬛⬜⬜⬜⬜⬜⬛⬜⬜⬜⬜⬜⬛⬜⬜⬛
⬛⬜⬜⬛⬛⬛⬛⬛⬛⬛⬜⬜⬛⬛⬛⬛⬜⬜⬛⬜⬜⬛
⬛⬜⬜⬜⬜⬜⬜⬜⬜⬛⬜⬜⬜⬜⬜⬛⬜⬜⬛⬜⬜⬛
⬛⬜⬜⬜⬜⬜⬜⬜⬜⬛⬜⬜⬜⬜⬜⬛⬜⬜⬛⬜⬜⬛
⬛⬜⬜⬛⬛⬛⬛⬛⬛⬛⬛⬛⬛⬛⬛⬛⬛⬛⬛⬛⬛⬛
⬛⬜⬜⬜⬜⬜⬜⬜⬜⬜⬜⬜⬜⬜⬜⬜⬜⬜⬜🟥🟥⬛
⬛⬜⬜⬜⬜⬜⬜⬜⬜⬜⬜⬜⬜⬜⬜⬜⬜⬜⬜🟥🟥⬛
⬛⬛⬛⬛⬛⬛⬛⬛⬛⬛⬛⬛⬛⬛⬛⬛⬛⬛⬛⬛⬛⬛

